"a" = (/turf/template_noop,/area/template_noop)
"b" = (/turf/closed/wall/r_wall,/area/ruin/space/abandoned_tele)
"c" = (/obj/structure/lattice,/turf/template_noop,/area/space/nearstation)
"d" = (/obj/structure/frame/computer,/turf/open/floor/plating/airless,/area/ruin/space/abandoned_tele)
"e" = (/obj/machinery/teleport/station,/turf/open/floor/plating/airless,/area/ruin/space/abandoned_tele)
"f" = (/obj/machinery/teleport/hub,/turf/open/floor/plating/airless,/area/ruin/space/abandoned_tele)
"g" = (/obj/item/shard{icon_state = "medium"},/turf/open/floor/plating/airless,/area/ruin/space/abandoned_tele)
"h" = (/turf/open/floor/plating/airless,/area/ruin/space/abandoned_tele)
"i" = (/obj/structure/rack,/obj/item/clothing/gloves/color/yellow,/turf/open/floor/plating/airless,/area/ruin/space/abandoned_tele)
"j" = (/obj/effect/spawner/structure/window/hollow/reinforced/end{dir = 8},/turf/open/floor/plating/airless,/area/ruin/space/abandoned_tele)
"k" = (/obj/effect/spawner/structure/window/hollow/reinforced/end{dir = 4},/turf/open/floor/plating/airless,/area/ruin/space/abandoned_tele)
"l" = (/obj/item/stock_parts/cell,/turf/open/floor/plating/airless,/area/ruin/space/abandoned_tele)
"m" = (/obj/effect/decal/cleanable/dirt,/turf/open/floor/plating/airless,/area/ruin/space/abandoned_tele)
"n" = (/obj/effect/decal/cleanable/robot_debris/old,/turf/open/floor/plating/airless,/area/ruin/space/abandoned_tele)
"o" = (/obj/effect/spawner/lootdrop/crate_spawner,/turf/open/floor/plating/airless,/area/ruin/space/abandoned_tele)
"p" = (/obj/machinery/door/airlock/external,/obj/effect/mapping_helpers/airlock/cyclelink_helper{dir = 4},/turf/open/floor/plating/airless,/area/ruin/space/abandoned_tele)
"q" = (/obj/effect/decal/cleanable/dirt,/obj/item/flashlight,/turf/open/floor/plating/airless,/area/ruin/space/abandoned_tele)
"r" = (/obj/effect/decal/cleanable/dirt,/obj/item/beacon,/turf/open/floor/plating/airless,/area/ruin/space/abandoned_tele)
"s" = (/obj/machinery/portable_atmospherics/canister/air,/turf/open/floor/plating/airless,/area/ruin/space/abandoned_tele)
"t" = (/obj/item/stack/sheet/glass{amount = 10},/turf/open/floor/plating/airless,/area/ruin/space/abandoned_tele)
"u" = (/obj/effect/decal/cleanable/blood/old,/turf/open/floor/plating/airless,/area/ruin/space/abandoned_tele)
"v" = (/obj/effect/decal/cleanable/oil,/turf/open/floor/plating/airless,/area/ruin/space/abandoned_tele)
"w" = (/obj/item/shard,/obj/item/electronics/apc,/turf/open/floor/plating/airless,/area/ruin/space/abandoned_tele)
"x" = (/obj/structure/closet,/turf/open/floor/plating/airless,/area/ruin/space/abandoned_tele)
"y" = (/obj/item/storage/toolbox/electrical{pixel_x = 1; pixel_y = -1},/turf/open/floor/plating/airless,/area/ruin/space/abandoned_tele)
"z" = (/obj/structure/closet/crate,/obj/item/aicard,/obj/item/multitool,/obj/item/weldingtool,/obj/item/wrench,/obj/item/circuitboard/computer/teleporter,/turf/open/floor/plating/airless,/area/ruin/space/abandoned_tele)
"A" = (/obj/structure/reagent_dispensers/fueltank,/turf/open/floor/plating/airless,/area/ruin/space/abandoned_tele)
"B" = (/obj/structure/girder,/turf/open/floor/plating/airless,/area/ruin/space/abandoned_tele)
"O" = (/obj/machinery/door/airlock/external,/obj/effect/mapping_helpers/airlock/cyclelink_helper{dir = 8},/turf/open/floor/plating/airless,/area/ruin/space/abandoned_tele)

(1,1,1) = {"
aaaaaabbbbbca
aaaccbbdefbba
acccbbghhhibb
aajkbhlmhnmob
ccphOhqnrhhsb
aajkbsuhvhwxb
acccbbthmhybb
aaaccbbzhAbba
aaaaaabbchBca
aaaaaacccacaa
aaaaaaacaaaaa
aaaaaaaaccaaa
"}
