//MAP CONVERTED BY dmm2tgm.py THIS HEADER COMMENT PREVENTS RECONVERSION, DO NOT REMOVE
"a" = (
/turf/closed/wall/mineral/titanium,
/area/shuttle/supply)
"b" = (
/obj/structure/window/shuttle/tinted,
/turf/open/floor/plating,
/area/shuttle/supply)
"c" = (
/obj/machinery/conveyor{
	dir = 2;
	id = "cargoshuttle";
	name = "cargo shuttle conveyor belt"
	},
/obj/effect/turf_decal/stripes/line{
	dir = 9
	},
/turf/open/floor/mineral/titanium/yellow,
/area/shuttle/supply)
"d" = (
/obj/machinery/conveyor{
	dir = 2;
	id = "cargoshuttle";
	name = "cargo shuttle conveyor belt"
	},
/obj/effect/turf_decal/stripes/line{
	dir = 1
	},
/obj/machinery/light{
	dir = 1
	},
/turf/open/floor/mineral/titanium/yellow,
/area/shuttle/supply)
"e" = (
/obj/machinery/conveyor{
	dir = 2;
	id = "cargoshuttle";
	name = "cargo shuttle conveyor belt"
	},
/obj/effect/turf_decal/stripes/line{
	dir = 5
	},
/turf/open/floor/mineral/titanium/yellow,
/area/shuttle/supply)
"f" = (
/obj/machinery/conveyor{
	dir = 4;
	id = "cargoshuttle";
	name = "cargo shuttle conveyor belt"
	},
/obj/effect/turf_decal/stripes/line{
	dir = 8
	},
/turf/open/floor/mineral/titanium/yellow,
/area/shuttle/supply)
"g" = (
/obj/machinery/conveyor{
	dir = 4;
	id = "cargoshuttle";
	name = "cargo shuttle conveyor belt"
	},
/turf/open/floor/mineral/titanium/yellow,
/area/shuttle/supply)
"h" = (
/obj/machinery/conveyor{
	dir = 4;
	id = "cargoshuttle";
	name = "cargo shuttle conveyor belt"
	},
/obj/effect/turf_decal/stripes/line{
	dir = 4
	},
/turf/open/floor/mineral/titanium/yellow,
/area/shuttle/supply)
"i" = (
/obj/machinery/conveyor{
	dir = 2;
	id = "cargoshuttle";
	name = "cargo shuttle conveyor belt"
	},
/turf/open/floor/mineral/titanium/yellow,
/area/shuttle/supply)
"j" = (
/obj/machinery/door/poddoor{
	id = "QMLoaddoor2";
	name = "supply dock loading door"
	},
/obj/structure/fans/tiny,
/obj/machinery/conveyor{
	dir = 4;
	id = "cargoshuttle";
	name = "cargo shuttle conveyor belt"
	},
/turf/open/floor/plating,
/area/shuttle/supply)
"k" = (
/obj/structure/window,
/obj/machinery/conveyor{
	dir = 1;
	id = "cargoshuttle";
	name = "cargo shuttle conveyor belt"
	},
/turf/open/floor/mineral/titanium/yellow,
/area/shuttle/supply)
"l" = (
/obj/machinery/status_display/supply,
/turf/closed/wall/mineral/titanium,
/area/shuttle/supply)
"m" = (
/obj/effect/turf_decal/stripes/line{
	dir = 9
	},
/turf/open/floor/mineral/titanium,
/area/shuttle/supply)
"n" = (
/obj/machinery/door/airlock/titanium{
	name = "Supply Shuttle Airlock";
	req_access_txt = "31"
	},
/obj/structure/fans/tiny,
/turf/open/floor/plating,
/area/shuttle/supply)
"o" = (
/obj/machinery/conveyor_switch/oneway{
	id = "cargoshuttle"
	},
/obj/effect/turf_decal/stripes/line{
	dir = 5
	},
/obj/machinery/button/door{
	dir = 2;
	id = "QMLoaddoor2";
	name = "Loading Doors";
	pixel_x = 24;
	pixel_y = 8
	},
/turf/open/floor/mineral/titanium,
/area/shuttle/supply)
"p" = (
/obj/structure/window,
/obj/machinery/conveyor{
	dir = 1;
	id = "cargoshuttle";
	name = "cargo shuttle conveyor belt"
	},
/obj/effect/turf_decal/stripes/line{
	dir = 10
	},
/turf/open/floor/mineral/titanium/yellow,
/area/shuttle/supply)
"q" = (
/obj/effect/turf_decal/stripes/line{
	dir = 1
	},
/turf/open/floor/mineral/titanium,
/area/shuttle/supply)
"r" = (
/obj/effect/turf_decal/stripes/line{
	dir = 8
	},
/turf/open/floor/mineral/titanium,
/area/shuttle/supply)
"s" = (
/obj/effect/turf_decal/bot,
/turf/open/floor/mineral/titanium,
/area/shuttle/supply)
"t" = (
/obj/structure/window/reinforced{
	dir = 1
	},
/obj/structure/shuttle/engine/heater,
/turf/open/floor/plating/airless,
/area/shuttle/supply)
"u" = (
/turf/template_noop,
/area/template_noop)
"v" = (
/obj/structure/shuttle/engine/propulsion/burst/left,
/turf/open/floor/plating/airless,
/area/shuttle/supply)
"w" = (
/obj/structure/shuttle/engine/propulsion,
/turf/open/floor/plating/airless,
/area/shuttle/supply)
"x" = (
/obj/structure/shuttle/engine/propulsion/burst/right,
/turf/open/floor/plating/airless,
/area/shuttle/supply)
"y" = (
/obj/effect/turf_decal/stripes/line{
	dir = 4
	},
/turf/open/floor/mineral/titanium,
/area/shuttle/supply)
"z" = (
/obj/effect/turf_decal/stripes/line,
/turf/open/floor/mineral/titanium,
/area/shuttle/supply)
"A" = (
/obj/effect/turf_decal/stripes/line,
/obj/machinery/conveyor_switch/oneway{
	dir = 8;
	id = "cargoshuttleIn"
	},
/turf/open/floor/mineral/titanium,
/area/shuttle/supply)
"B" = (
/obj/machinery/door/airlock/titanium{
	name = "Supply Shuttle Airlock";
	req_access_txt = "31"
	},
/obj/docking_port/mobile/supply{
	dwidth = 3;
	width = 12
	},
/obj/structure/fans/tiny,
/turf/open/floor/plating,
/area/shuttle/supply)
"C" = (
/obj/machinery/door/window,
/obj/machinery/conveyor{
	dir = 1;
	id = "cargoshuttle";
	name = "cargo shuttle conveyor belt"
	},
/turf/open/floor/mineral/titanium/yellow,
/area/shuttle/supply)
"D" = (
/obj/structure/window,
/obj/machinery/conveyor{
	dir = 1;
	id = "cargoshuttle";
	name = "cargo shuttle conveyor belt"
	},
/obj/effect/turf_decal/stripes/line{
	dir = 6
	},
/turf/open/floor/mineral/titanium/yellow,
/area/shuttle/supply)
"E" = (
/obj/machinery/door/poddoor{
	id = "QMLoaddoor";
	name = "supply dock loading door"
	},
/obj/structure/fans/tiny,
/obj/machinery/conveyor{
	dir = 8;
	id = "cargoshuttleIn";
	name = "cargo shuttle conveyor belt"
	},
/turf/open/floor/plating,
/area/shuttle/supply)
"F" = (
/obj/machinery/conveyor{
	dir = 9;
	id = "cargoshuttleIn";
	name = "cargo shuttle conveyor belt"
	},
/obj/effect/turf_decal/stripes/line{
	dir = 10
	},
/turf/open/floor/mineral/titanium/blue,
/area/shuttle/supply)
"G" = (
/obj/machinery/conveyor{
	dir = 8;
	id = "cargoshuttleIn";
	name = "cargo shuttle conveyor belt"
	},
/obj/effect/turf_decal/stripes/line,
/turf/open/floor/mineral/titanium/blue,
/area/shuttle/supply)
"H" = (
/obj/machinery/light{
	dir = 8
	},
/obj/effect/turf_decal/stripes/line{
	dir = 8
	},
/turf/open/floor/mineral/titanium,
/area/shuttle/supply)
"I" = (
/obj/machinery/button/door{
	id = "QMLoaddoor";
	name = "Loading Doors";
	pixel_x = 24;
	pixel_y = -8
	},
/obj/machinery/light{
	dir = 4
	},
/obj/effect/turf_decal/stripes/line{
	dir = 4
	},
/turf/open/floor/mineral/titanium,
/area/shuttle/supply)
"J" = (
/obj/effect/turf_decal/loading_area{
	dir = 1
	},
/obj/effect/turf_decal/stripes/line{
	dir = 8
	},
/turf/open/floor/mineral/titanium,
/area/shuttle/supply)
"K" = (
/obj/effect/turf_decal/stripes/line{
	dir = 6
	},
/turf/open/floor/mineral/titanium,
/area/shuttle/supply)
"L" = (
/turf/closed/wall/mineral/titanium/nodiagonal,
/area/shuttle/supply)

(1,1,1) = {"
u
a
a
a
a
l
a
a
a
a
L
u
"}
(2,1,1) = {"
a
a
c
f
p
m
r
H
J
F
a
v
"}
(3,1,1) = {"
b
c
i
g
k
q
s
s
z
G
t
w
"}
(4,1,1) = {"
b
d
i
g
C
q
s
s
A
G
t
w
"}
(5,1,1) = {"
b
e
i
g
k
q
s
s
z
G
t
w
"}
(6,1,1) = {"
a
a
e
h
D
o
y
I
K
G
a
x
"}
(7,1,1) = {"
u
a
a
j
a
a
n
a
B
E
a
u
"}
