"a" = (/turf/closed/wall/rust,/area/shuttle/escape)
"b" = (/obj/machinery/door/airlock/maintenance_hatch,/obj/docking_port/mobile/emergency,/turf/open/floor/plating,/area/shuttle/escape)
"c" = (/turf/open/floor/plating,/area/shuttle/escape)
"d" = (/obj/machinery/sleeper,/turf/open/floor/plating,/area/shuttle/escape)
"e" = (/obj/machinery/door/window/brigdoor/security/cell/northright,/obj/machinery/door/window/brigdoor/security/cell/eastleft,/turf/open/floor/mineral/plastitanium/red/brig,/area/shuttle/escape)
"f" = (/obj/machinery/computer/emergency_shuttle{dir = 8},/turf/open/floor/plating,/area/shuttle/escape)

(1,1,1) = {"
aaaa
bcda
aefa
aaaa
"}
