//MAP CONVERTED BY dmm2tgm.py THIS HEADER COMMENT PREVENTS RECONVERSION, DO NOT REMOVE
"a" = (
/turf/closed/indestructible/riveted,
/area/hippie/thanos_farm)
"b" = (
/turf/open/floor/grass,
/area/hippie/thanos_farm)
"c" = (
/obj/structure/bonfire/prelit,
/turf/open/floor/grass,
/area/hippie/thanos_farm)
"d" = (
/turf/closed/wall/mineral/wood,
/area/hippie/thanos_farm)
"e" = (
/obj/machinery/vending/hydroseeds,
/turf/open/floor/carpet/black,
/area/hippie/thanos_farm)
"f" = (
/obj/machinery/vending/hydronutrients,
/turf/open/floor/carpet/black,
/area/hippie/thanos_farm)
"g" = (
/turf/open/floor/carpet/black,
/area/hippie/thanos_farm)
"h" = (
/obj/structure/reagent_dispensers/watertank/high,
/turf/open/floor/carpet/black,
/area/hippie/thanos_farm)
"i" = (
/obj/structure/table/wood,
/turf/open/floor/carpet/black,
/area/hippie/thanos_farm)
"j" = (
/obj/structure/table/wood,
/obj/item/reagent_containers/glass/bowl,
/obj/item/reagent_containers/glass/bowl,
/obj/item/reagent_containers/glass/bowl,
/obj/item/reagent_containers/glass/bowl,
/turf/open/floor/carpet/black,
/area/hippie/thanos_farm)
"k" = (
/obj/structure/table/wood,
/obj/item/reagent_containers/glass/bucket,
/obj/item/reagent_containers/glass/bucket,
/obj/item/reagent_containers/glass/bucket,
/turf/open/floor/carpet/black,
/area/hippie/thanos_farm)
"l" = (
/obj/structure/table/wood,
/obj/item/melee/roastingstick,
/obj/item/melee/roastingstick,
/turf/open/floor/carpet/black,
/area/hippie/thanos_farm)
"m" = (
/obj/structure/table/wood,
/obj/item/reagent_containers/food/snacks/grown/watermelon,
/obj/item/reagent_containers/food/snacks/grown/watermelon,
/turf/open/floor/carpet/black,
/area/hippie/thanos_farm)
"n" = (
/obj/machinery/hydroponics/soil,
/turf/open/floor/grass,
/area/hippie/thanos_farm)
"o" = (
/obj/effect/landmark/start/thanos_portal,
/turf/open/floor/grass,
/area/hippie/thanos_farm)
"p" = (
/obj/machinery/hydroponics/soil,
/obj/effect/landmark/start/thanos_portal,
/turf/open/floor/grass,
/area/hippie/thanos_farm)
"q" = (
/obj/effect/landmark/start/thanos,
/turf/open/floor/carpet/black,
/area/hippie/thanos_farm)
"r" = (
/obj/machinery/computer/camera_advanced,
/turf/open/floor/carpet/black,
/area/hippie/thanos_farm)
"s" = (
/obj/machinery/telecomms/relay/preset/auto,
/turf/open/floor/carpet/black,
/area/hippie/thanos_farm)

(1,1,1) = {"
a
a
a
a
a
a
a
a
a
a
a
a
a
a
a
a
a
a
a
a
a
a
a
a
a
a
a
a
a
a
a
a
a
a
a
a
a
a
a
a
a
a
a
a
a
a
a
a
a
a
a
a
a
a
a
"}
(2,1,1) = {"
a
n
n
n
n
n
n
n
n
n
n
n
n
n
n
n
n
n
n
n
n
n
n
n
n
n
n
n
n
n
n
n
n
n
n
n
n
n
n
n
n
n
n
n
b
b
b
b
b
b
b
b
b
b
a
"}
(3,1,1) = {"
a
n
n
n
n
n
n
n
n
n
n
n
n
n
n
n
n
n
n
n
n
n
n
n
n
n
n
n
n
n
n
n
n
n
n
n
n
n
n
n
n
n
n
n
b
b
b
b
b
b
b
b
b
b
a
"}
(4,1,1) = {"
a
n
p
n
n
n
n
n
n
n
n
n
n
n
n
n
n
n
n
n
n
n
n
n
n
n
n
n
n
n
n
n
n
n
n
n
n
n
n
n
n
n
n
n
b
b
b
b
b
b
b
b
b
b
a
"}
(5,1,1) = {"
a
n
n
n
n
n
p
n
n
n
n
n
n
n
n
n
n
n
n
n
n
n
n
n
n
n
n
n
n
n
n
n
n
n
n
n
n
n
n
n
n
n
n
n
b
b
b
b
b
b
b
b
b
b
a
"}
(6,1,1) = {"
a
n
n
n
n
n
n
n
n
n
n
n
n
n
n
n
n
n
n
n
n
n
n
n
n
n
n
n
n
n
n
n
n
n
n
n
n
n
n
n
n
n
n
n
b
b
b
b
b
b
b
b
b
b
a
"}
(7,1,1) = {"
a
n
n
n
n
n
n
n
n
n
n
n
n
n
n
n
n
n
n
n
n
n
n
n
n
n
n
n
n
n
n
n
n
n
n
n
n
n
n
n
n
n
n
n
b
d
d
d
d
d
d
d
b
b
a
"}
(8,1,1) = {"
a
n
n
n
p
n
n
n
n
n
n
n
n
n
n
n
n
n
n
n
n
n
n
n
n
n
n
n
n
n
n
n
n
n
n
n
n
n
n
n
n
n
n
n
b
d
e
g
i
i
i
d
b
b
a
"}
(9,1,1) = {"
a
n
n
n
n
n
n
n
n
n
n
n
n
n
n
n
n
n
n
n
n
n
n
n
n
n
n
n
n
n
n
n
n
n
n
n
n
n
n
n
n
n
n
n
b
d
f
g
g
q
j
d
b
b
a
"}
(10,1,1) = {"
a
n
n
n
n
n
n
n
n
n
n
n
n
n
n
n
n
n
n
n
n
n
n
n
n
n
n
n
n
n
n
n
n
n
n
n
n
n
n
n
n
n
n
n
b
d
g
g
g
g
k
d
b
b
a
"}
(11,1,1) = {"
a
n
n
n
n
n
n
n
n
n
n
n
n
n
n
n
n
n
n
n
n
n
n
n
n
n
n
n
n
n
n
n
n
n
n
n
n
n
n
n
n
n
n
n
b
d
g
q
g
g
l
d
b
b
a
"}
(12,1,1) = {"
a
b
b
b
b
o
b
b
b
b
b
b
b
b
b
b
b
b
b
b
b
b
b
b
b
b
b
b
b
b
b
b
b
b
b
b
b
b
b
b
b
b
b
b
c
d
g
g
g
g
i
d
b
b
a
"}
(13,1,1) = {"
a
o
b
b
b
b
b
b
b
b
b
b
b
b
b
b
b
b
b
b
b
b
b
b
b
b
b
b
b
b
b
b
b
b
b
b
b
b
b
b
b
b
b
b
b
b
g
g
g
q
i
d
b
b
a
"}
(14,1,1) = {"
a
b
b
b
b
b
b
b
b
b
b
b
b
b
b
b
b
b
b
b
b
b
b
b
b
b
b
b
b
b
b
b
b
b
b
b
b
b
b
b
b
b
b
b
c
d
g
g
g
g
i
d
b
b
a
"}
(15,1,1) = {"
a
n
n
n
n
n
n
n
n
n
n
n
n
n
n
n
n
n
n
n
n
n
n
n
n
n
n
n
n
n
n
n
n
n
n
n
n
n
n
n
n
n
n
n
b
d
g
q
g
g
i
d
b
b
a
"}
(16,1,1) = {"
a
n
n
n
n
n
n
n
n
n
n
n
n
n
n
n
n
n
n
n
n
n
n
n
n
n
n
n
n
n
n
n
n
n
n
n
n
n
n
n
n
n
n
n
b
d
s
g
g
g
m
d
b
b
a
"}
(17,1,1) = {"
a
n
n
p
n
n
n
n
n
n
n
n
n
n
n
n
n
n
n
n
n
n
n
n
n
n
n
n
n
n
n
n
n
n
n
n
n
n
n
n
n
n
n
n
b
d
r
g
g
q
m
d
b
b
a
"}
(18,1,1) = {"
a
n
n
n
n
n
n
n
n
n
n
n
n
n
n
n
n
n
n
n
n
n
n
n
n
n
n
n
n
n
n
n
n
n
n
n
n
n
n
n
n
n
n
n
b
d
h
g
i
i
i
d
b
b
a
"}
(19,1,1) = {"
a
n
n
n
n
n
n
n
n
n
n
n
n
n
n
n
n
n
n
n
n
n
n
n
n
n
n
n
n
n
n
n
n
n
n
n
n
n
n
n
n
n
n
n
b
d
d
d
d
d
d
d
b
b
a
"}
(20,1,1) = {"
a
n
p
n
n
n
n
p
n
n
n
n
n
n
n
n
n
n
n
n
n
n
n
n
n
n
n
n
n
n
n
n
n
n
n
n
n
n
n
n
n
n
n
n
b
b
b
b
b
b
b
b
b
b
a
"}
(21,1,1) = {"
a
n
n
n
n
n
n
n
n
n
n
n
n
n
n
n
n
n
n
n
n
n
n
n
n
n
n
n
n
n
n
n
n
n
n
n
n
n
n
n
n
n
n
n
b
b
b
b
b
b
b
b
b
b
a
"}
(22,1,1) = {"
a
n
n
n
n
n
n
n
n
n
n
n
n
n
n
n
n
n
n
n
n
n
n
n
n
n
n
n
n
n
n
n
n
n
n
n
n
n
n
n
n
n
n
n
b
b
b
b
b
b
b
b
b
b
a
"}
(23,1,1) = {"
a
n
n
n
n
n
n
n
n
n
n
n
n
n
n
n
n
n
n
n
n
n
n
n
n
n
n
n
n
n
n
n
n
n
n
n
n
n
n
n
n
n
n
n
b
b
b
b
b
b
b
b
b
b
a
"}
(24,1,1) = {"
a
n
n
n
n
n
n
n
n
n
n
n
n
n
n
n
n
n
n
n
n
n
n
n
n
n
n
n
n
n
n
n
n
n
n
n
n
n
n
n
n
n
n
n
b
b
b
b
b
b
b
b
b
b
a
"}
(25,1,1) = {"
a
a
a
a
a
a
a
a
a
a
a
a
a
a
a
a
a
a
a
a
a
a
a
a
a
a
a
a
a
a
a
a
a
a
a
a
a
a
a
a
a
a
a
a
a
a
a
a
a
a
a
a
a
a
a
"}
